pig	lợn
chicken	gà
dog	chó
flower	hoa
rose	hoa hồng
sunflower	hoa hướng dương
water	nước
ocean	biển cả
bike	xe đạp
truck	xe tải
plane	máy bay
window	cửa sổ
cottage	nhà tranh
gun	súng
plankton	sinh vật phù du
love	tình yêu
shadow	bóng đêm
god	thánh
garbage	thùng rác
legend	huyền thoại
bird	con chim
